9999999999999999999999999999999999999999
9999999999999999999999999999999999999999
9999999900099999999999999999999000999999
9999999000009999999999999999990000099999
9999990000000999999999999999900000009999
9999900000000099999999999999000000000999
9999000000000009999999999990000000000099
9990000000000000999999999900000000000009
9900000000000000099999999000000000000000
9000000000000000009999990000000000000000
0000000000000000000999900000000000000000
0000000000000000000099000000000000000000
0000000000000000000000000000000000000000
0000000000000000000000000000000000000000
1110000000000000000000000000000000000000
0000000000000000000000000000000000000000
0000000000000000000000000000000000000000
0000000000000000000000000000000000000000
0000000000000000000099000000000000000000
0000000000000000000999900000000000000000
9000000000000000009999990000000000000000
9900000000000000099999999000000000000000
9990000000000000999999999900000000000009
9999000000000009999999999990000000000099
9999900000000099999999999999000000000999
9999990000000999999999999999900000009999
9999999000009999999999999999990000099999
9999999900099999999999999999999000999999
9999999999999999999999999999999999999999
9999999999999999999999999999999999999999