0000000000000000000000000000000000000000
0000000000000000000000000000000000000000
0999999999999999999999999999999999999990
0900000000000000000000000000000000000090
0900000000000000000000000000000000000090
0900999999999999999999999999999999990090
0900900000000000000000000000000000090090
0900900000000000000000000000000000090090
0900900999999999999999999999999990090090
0900900900000000000000000000000090090090
0900900900000000000000000000000090090090
0900900900999999999999999999990090090090
0900900900900000000000000000090090090090
0900900900900000000000000000090090090090
0900900900900000000000000000090090090090
0900900900900000000000000000090090090090
0900900900000000000000000000090090090090
0900900900000000000000000000090090090090
0900900900000000000000000000090090090090
0900900900000000000000000000090090090090
0900900900000000000000000000090090090090
0900900999999999999999999999990090090090
0900900000000000000000000000000090090090
0900900000000000000000000000000090090090
0900999999999999999999999999999990090090
0900000000000000000000000000000000090090
0900000000000000000000000000000000090090
0999999999999999999999999999999999990090
0111000000000000000000000000000000000000
0000000000000000000000000000000000000000