9999990000000000000000000000000000999999
9999990000000000000000000000000000999999
9999990000000000000000000000000000999999
9999990000000000000000000000000000999999
9999990000000000009999000000000000999999
9999990000000000009999000000000000999999
0000000000000000009999000000990000000000
0000000000000000009999000000990000000000
0000000000000000000000000000990000000000
0000000000000000000000000000990000000000
0000000000999999009999009999990000000000
0000000000999999009999009999990000000000
0000000000990000009999000000000000000000
0000000000990000009999000000000000000000
0000000000990000009999000000000000000000
0000000000990000009999000000000000000000
0000000000000000009999000000000000000000
0000000000000000009999000000000000000000
0000000000000000000000000000000000000000
0000000000000000000000000000000000000000
0000000000000000990000999999990000000000
0111000000000000990000999999990000000000
0000000000000000990000000000990000000000
0000000000000000990000000000990000000000
0000000000999999990000000000990000000000
0000000000999999990000000000990000000000
0000000000990000000000000000999900000000
0000000000990000000000000000999900000000
0000000000000000000000000000000000000000
0000000000000000000000000000000000000000